Map 1:
10
-.P.-.-.-.-.-.-.-.-
P.P.-.-.-.P.-.-.P.-
-.-.-.-.-.-.-.-.-.-
-.P.-.P.-.-.P.-.-.-
-.-.-.-.-.-.-.P.-.-
-.P.-.P.W.-.P.P.-.-
-.-.-.P.-.P.P.G.P.-
-.-.P.-.P.P.-.-.-.P
-.-.-.-.-.-.-.-.P.-
A.-.-.-.-.-.-.-.-.-

Sensors for Stench:
[[0, 0, 0, 0, 0, 0, 0, 0, 0, 0], 
[0, 0, 0, 0, 0, 0, 0, 0, 0, 0], 
[0, 0, 0, 0, 0, 0, 0, 0, 0, 0], 
[0, 0, 0, 0, 0, 0, 0, 0, 0, 0], 
[0, 0, 0, 0, 1, 0, 0, 0, 0, 0], 
[0, 0, 0, 1, 0, 1, 0, 0, 0, 0], 
[0, 0, 0, 0, 1, 0, 0, 0, 0, 0], 
[0, 0, 0, 0, 0, 0, 0, 0, 0, 0], 
[0, 0, 0, 0, 0, 0, 0, 0, 0, 0], 
[0, 0, 0, 0, 0, 0, 0, 0, 0, 0]]

Sensors for Breeze:
[[1, 1, 1, 0, 0, 1, 0, 0, 1, 0], 
[1, 1, 1, 0, 1, 0, 1, 1, 0, 1], 
[1, 1, 0, 1, 0, 1, 1, 0, 1, 0], 
[1, 0, 1, 0, 1, 1, 0, 1, 0, 0], 
[0, 1, 0, 1, 0, 0, 1, 1, 1, 0], 
[1, 0, 1, 1, 1, 1, 1, 1, 1, 0], 
[0, 1, 1, 1, 1, 1, 1, 1, 0, 1], 
[0, 1, 0, 1, 1, 1, 1, 0, 1, 0], 
[0, 0, 1, 0, 1, 1, 0, 1, 0, 1], 
[0, 0, 0, 0, 0, 0, 0, 0, 1, 0]]

Sensors for Glitter:
[[0, 0, 0, 0, 0, 0, 0, 0, 0, 0], 
[0, 0, 0, 0, 0, 0, 0, 0, 0, 0], 
[0, 0, 0, 0, 0, 0, 0, 0, 0, 0], 
[0, 0, 0, 0, 0, 0, 0, 0, 0, 0], 
[0, 0, 0, 0, 0, 0, 0, 0, 0, 0], 
[0, 0, 0, 0, 0, 0, 0, 0, 0, 0], 
[0, 0, 0, 0, 0, 0, 0, 1, 0, 0], 
[0, 0, 0, 0, 0, 0, 0, 0, 0, 0], 
[0, 0, 0, 0, 0, 0, 0, 0, 0, 0], 
[0, 0, 0, 0, 0, 0, 0, 0, 0, 0]]
