10
-.-.-.-.-.P.-.P.-.-
-.-.G.-.-.G.P.G.P.P
-.-.-.-.-.-.P.P.-.-
-.P.P.P.P.-.-.-.W.G
-.P.P.P.-.-.-.-.G.-
P.-.P.P.-.-.P.P.-.-
-.-.P.-.-.-.-.P.-.-
-.-.P.-.-.-.-.-.G.-
G.G.-.P.P.P.P.-.-.-
-.-.A.-.P.-.P.-.-.-
