10
W.-.P.-.P.-.-.-.-.P
G.-.-.-.P.-.-.P.P.P
P.-.P.-.P.-.-.-.-.-
-.-.-.-.P.-.-.P.-.G
-.-.-.G.-.-.P.G.G.P
-.-.G.P.-.-.-.P.A.-
-.G.-.P.P.P.-.-.-.-
-.-.P.-.-.P.P.P.P.P
-.-.G.-.G.G.P.G.P.-
-.P.P.P.P.-.P.G.-.G
