10
-.P.-.-.P.-.-.-.-.-
P.-.-.-.-.-.-.-.-.-
P.P.W.-.P.W.-.-.-.-
-.-.W.-.A.-.-.W.-.-
-.-.W.-.-.-.P.P.-.W
-.W.-.-.-.-.-.P.-.P
-.P.W.-.-.P.-.-.-.G
-.-.P.-.-.-.-.-.W.-
-.P.-.P.-.-.W.P.-.-
-.-.-.W.P.P.-.-.-.P
