10
-.-.-.-.-.P.-.W.P.-
-.-.P.-.-.-.-.-.P.W
-.-.-.-.-.-.W.-.-.-
-.W.-.-.P.-.-.-.-.-
-.-.-.-.P.-.G.-.-.-
-.-.-.-.-.-.-.-.P.-
-.P.P.-.-.-.-.P.-.P
-.P.-.-.-.-.-.-.-.P
-.-.-.-.-.-.P.-.-.P
-.A.-.-.-.-.-.-.-.-
