10
-.P.-.-.-.G.P.P.-.-
G.-.-.P.G.P.G.P.-.-
P.-.-.P.P.P.P.-.P.-
W.-.-.W.-.P.-.P.-.W
G.-.-.P.W.-.-.W.P.-
-.-.P.G.-.W.W.-.-.-
-.-.-.-.-.P.-.W.-.-
G.-.-.-.G.-.-.P.P.-
P.-.-.-.A.-.-.W.G.-
-.G.-.-.W.-.-.-.-.-
