10
W.-.-.P.-.P.P.-.P.-
W.W.G.-.W.P.-.-.G.G
-.-.-.-.-.P.G.P.G.-
P.P.P.-.-.P.-.-.-.-
-.P.-.P.-.-.-.-.P.-
-.W.-.W.A.-.W.-.-.P
P.-.-.P.W.W.W.-.-.-
-.-.-.-.-.-.-.-.-.P
P.-.-.-.-.-.-.-.P.-
-.-.-.-.P.-.-.-.-.-
