10
-.-.P.W.-.-.-.-.-.-
W.-.P.P.G.-.P.-.-.P
-.-.G.P.-.W.P.P.P.-
-.-.-.G.W.-.W.-.-.-
-.-.-.W.W.-.-.A.-.-
G.-.P.-.-.W.-.-.-.-
-.-.G.P.P.-.-.-.W.-
-.-.-.P.-.P.-.G.-.P
-.-.G.-.W.G.-.-.P.-
-.P.P.-.G.-.-.P.P.G
