10
-.G.-.-.G.G.P.P.-.G
P.-.-.-.-.-.-.P.G.-
P.-.-.P.-.W.-.-.-.-
-.W.-.G.-.-.-.W.-.-
-.-.-.-.-.-.-.-.-.-
-.-.-.-.-.-.P.-.A.G
-.-.-.-.-.-.W.-.-.-
-.-.-.P.-.-.W.-.-.-
-.-.-.-.-.-.-.-.-.G
-.-.-.-.P.G.-.G.-.P
